{
  "a" : 0,
  "b" : 1,
  "c" : 2,
  "d" : 3,
  "e" : 4,
  "f" : 5,
  "g" : 6,
  "h" : 7,
  "j" : 8,
  "k" : 9,
  "l" : 10,
  "m" : 11,
  "n" : 12,
  "p" : 13,
  "q" : 14,
  "r" : 15,
  "s" : 16,
  "t" : 17,
  "u" : 18,
  "v" : 19,
  "w" : 20,
  "x":  21,
  "y" : 22,
  "z" : 23,
  "0" : 24,
  "1" : 25,
  "2" : 26,
  "3" : 27,
  "4" : 28,
  "5" : 29,
  "6" : 30,
  "7" : 31,
  "8" : 32,
  "9" : 33
}
