{
  "皖": 0,
  "沪": 1,
  "津": 2,
  "渝": 3,
  "冀": 4,
  "晋": 5,
  "蒙": 6,
  "辽": 7,
  "吉": 8,
  "黑": 9,
  "苏": 10,
  "浙": 11,
  "京": 12,
  "闽": 13,
  "赣": 14,
  "鲁": 15,
  "豫": 16,
  "鄂": 17,
  "湘": 18,
  "粤": 19,
  "桂": 20,
  "琼": 21,
  "川": 22,
  "贵": 23,
  "云": 24,
  "西": 25,
  "陕": 26,
  "甘": 27,
  "青": 28,
  "宁": 29,
  "新": 30
}
